X O O O O O O O O O O O O O O O O O O O O O O O O O O O O O O O O O O O O O O O O O O O O O O O O O X X
X O O O O O O O O O O O O O O O O O O O O O O O O O O O O O O O O O O O O O O O O O O O O O O O O O X X
X O O O O O O O O O O O O O O O O O O O O O O O O O O O O O O O O O O O O O O O O O O O O O O O O O X X
X O O O O O O O O O O O O O O O O O O O O O O O O O O O O O O O O O O O O O O O O O O O O O O O O O X X
X O O O O O O O O O O O O O O O O O O O O O O O O O O O O O O O O O O O O O O O O O O O O O O O O O X X
X O O O O O O O O O O J O O O O O O O O O O O O O O O O O O O O O O O O J O O O O O J O O O O O O J X X
X O O O O O O O O O O X B B B X O O O O O O O O O O O O O O O O O O O O O O O O O O O O O O O O O O X X
X O O O O O X X O O O X X X X X X X O J O X X O O O X X O O X X X X X X X X X X X X X X X X O O O O X X
X O O O O X X O O X O X Z Z Z Z Z X O O O X X O O O X X O O X X O O O O O O O O O O O O O O O O O O X X
X O O O X X O O O O O X X X X X X X O X O X X O O O X X O O X X O O O O O O O O O O S O S O O O X X X X
X O O O O O O O O O O O O O O O O O O O O O O O O O O O O O O O O O O O O O O O O O O O O O O O X X X X
X O O O O O O O O O O O O O O O O O O O O O O O O O O O O O O O O O U O O O O O O O X X X X X X X X X X
X O X X O J O X O O O O O O O O O O O O O O O O O O O O O O O O O O O O O O O O O O O O O O X X X X X X
X O X X O O O X X X O O O O O O M O O O O O O O O O O O O O O O X X X O O O O O O O O O O O O O O O X X
X O O O O X O X X X X X O O O O O O O O O O O O O O O O O O O O X Z X O O O O O X X O O O O O O O O X X
X O O O O O O X X X X X X O O J X X X X X O O O O O O O O O O O X Z X O O O O O X X O O O O O O O O X X
X O O O O O O O O O O O O O O O O O O O O O O O O O O O O O O O X Z X O O O O O O O O O O O O O O O X X
X O O O O O O O O O O O O O X X O O O O O O X X X O O O O O S O X Z X O O O O O O O O O O O O O O O X X
X O O O O O O O O O O O O O O O O O U O O O O O O O O O O O O O X Z X O O O O O O O O O O O O O O O X X
X O O O O O O O O O O O O O O O O O O O J O O O O X X X O O X O X X O O O O O O O O O O O O O O W O X X
X O O O O O O O O O O O O O O O O O O O O O O O O O O O O O O O X X O O O O O O O O O X B B X O O O X X
X O O O O O O O O X X O O O O X X X X X X X O O O O O O O O X X X X O O O O O O O O O X X X X X X X X X
X O O O O O O O O X R O O O O O O X Z Z Z X O O O O O O X X X X X X O O O O O O O O O X X X X X X X X X
X O O O O O O O O X X X X O O O O X Z Z Z X O O O O X X X Z Z Z Z X O O O O O O O O O O O O O O O O X X
X O O O O O O O O O O O O O O O O X Z Z Z X O O X X X Z Z Z Z Z Z X O O O O O O O O O O O O O O O O X X
X O O O O O O O O O O O O O O O O X Z Z Z X O O X Z Z Z Z Z Z Z Z X O O O O O O O O O O O O O O O O X X
X O P O O O O O O O O O O O O X X X Z Z Z X O O X Z Z Z Z Z Z Z Z X O O O O O O O O O O O O O O O O X X
X O O O O O O O O X B X O O X X Z Z Z Z Z X O O X Z Z Z Z Z Z Z Z X O O O O O O O O O O O O O O O O X X
X X X X X X O O O X X X X X X X X X X X X X O O X X X X X X X X X X O O O O O O O O O O O O O O O O X X