Z O O O O O O O O O O O O O O O O O O O O O O O O O O O O O O O O O O O O O O O O O O O O O O O O O Z Z
Z O O O O O O O O O O O O O O O O O O O O O O O O O O O O O O O O O O O O O O O O O O O O O O O O O Z Z
Z O O O O O O O O O O O O O O O O O O O O O O O O O O O O O O O O O O O O O O O O O O O O O O O O O Z Z
Z O O O O O O O O O O O O O O O O O O O O O O O O O O O O O O O O O O O O O O O O O O O O O O O O J Z Z
Z O P O O O O O O O O O O O O O O O O O O O O O O O O O O O O O O O O O O O O O O O O O O O O O O O Z Z
Z O O O O O O O O O O O O O O O O O O O O O O O O O O O O O O O O O O O O O O O O O O O O O O O O O Z Z
Z X X X X X O O O O O O O O O O O O O O O O O O O O O O O O O O O O O O O O O O O O O O O O O S O O Z Z
Z X X X X X O O O O O O O O O O O O O O O O O O O O O O O O O O O O O O O O O O O O O O O O O O O O Z Z
Z O O O X X O O O O O O O O O O O O O O O O O O O O O O O O O O O O O O O X X X X O O O O O X X X X Z Z
Z O O O X X O O O O O X X X X X X X O O O O O O O O O O O O O O O O O O O X Z Z X O O X O O X Z Z Z Z Z
Z O O O X X X X X X X X Z Z Z Z Z X X X X O O O O O O O O O O O O X X X X X Z Z X O O O O O X Z Z Z Z Z
Z O O O X X X X X Z Z Z Z Z Z Z Z Z Z Z R O O O O O O O O O O O O X Z Z Z Z Z Z X O O O O O X Z Z Z Z Z
Z O O O O O O O X Z Z Z Z Z Z Z Z Z Z Z X X X X O O O O O X X X X X Z Z Z Z Z Z X O O O O O X Z Z Z Z Z
Z O O O O O O O X X Z Z Z Z Z Z Z Z Z Z Z Z Z X B B B B X X Z Z Z Z Z Z Z Z Z Z X O O O O O X Z Z Z Z Z
Z O O O O O O O O X X X X X X X X X X Z Z Z Z X X X X X X Z Z Z Z Z Z Z Z Z Z Z X O O O O O X Z Z Z Z Z
Z O O O O O O O O O O O O O O O O O X X X X X Z Z Z Z Z Z Z Z Z Z Z Z Z Z Z Z Z X O O O O O X Z Z Z Z Z
Z O O O O O O O O O O O O O O O O O O O O O X X X X X X X X X X X X X X X X X X X O O O O O X Z Z Z Z Z
Z O O O O O O O O O O O O O O O O O O O O O O O O O O O O O O O O O O O O O O O O O O O O O X Z Z Z Z Z
Z O O O O O O O O O O O O O O O O O O O O O O O O O O O O O O O O O O O O O O O O O O O O O X Z Z Z Z Z
Z O W O O O O O O O O O O O O O O O O O O O O O O O O O O O O O O O O O O O O O O O O O O O X Z Z Z Z Z
Z O O O O O O O O O O O O O O O O O O O O O O O O O O O O O O O O O O O O O O O O O O O O O X Z Z Z Z Z
Z X X X X X O O O O O O O O O O O O O O O O O O O O O O O O O O O O O O O O O O O O O O O O X Z Z Z Z Z
Z X X X X X O O O O O O O O O O O O O J O O X X X O O O O O O O O O O O O O O O O O O O O O X Z Z Z Z Z
Z O O O O O O O O X X X O O O O O X X O O X X Z X O O O O X X X X X X X O O O O O O O O O O X Z Z Z Z Z
Z O O O O O O O O L Z R O O O O O X X B B X Z Z X O O O O X Z Z Z Z Z R O O O O O O O O O O X Z Z Z Z Z
Z O O O O O O O O X X X X O O O O X Z Z Z Z Z Z X O O O O X Z Z Z Z Z X X X X O O O O U O O X Z Z Z Z Z
Z O O O O O O O O O O O O O O O X X Z Z Z Z Z Z X O O O O X Z Z Z Z Z Z Z Z R O O O O O O O X Z Z Z Z Z
Z O O O O O O O O O O O O O X X X Z Z Z Z Z Z Z X O O O O X Z Z Z Z Z Z Z Z X X X O O O O O X Z Z Z Z Z
Z O O O O O O O O O O O O O X X X X X X X X X X X O O O O X X X X X X X X X X X X X X X X X X X X X X X