O O O O O O O O O O O O O O O O O O O O O O O O O O O O O O O O O O O O O O O O O O O O O O O O O O O O O O O O O O O O O O O O X
X O O O O O O O O O O O O O O O O O O O O O O O O O O O O O O O O O O O O O O O O O O O O O O O O O O O O O O O O O O O O O O O X
X O O O O O O O O O O O O O O O O O O O O O O O O O O O O O O O O O O O O O O O O O O O O O O O O O O O O O O O O O O O O O O O X
X O O O O O O O O O O O O O O O O O O O O O O O O O O O O O O O O O O O O O O O O O O O O O O O O O X O O O O O O O O O O O O O X
X O O O O O O O O O O O O O O O O O O O O O O O O O O O O O O O O O M X O O O O O O O O O O O O O O X O O O O O O O O O O O O O X
X O O O O O O O O O O O O O O O U O X O O O O M O O X O O O X X O O O X O O X X X O O O O X X O X O O O O O O O O O O O O O O O X
X O O O O O O O O O O O O O O X X X X O O O X O O O X O O O O O O O X X O O O O O X O O O O O O O X O O O O O O O O O O O O O O X
X O O O O O O O O O O O O O O O O O O O X O X X X X X U O O O O O O O O O O O O X O O O O O O O O O X U O O O O O O O O O O O O X
X O O O O O O O O O M M O O O O O O O O X O O O O O O X X X X X O O O O O O X X X X X X O O O O O O O X X O O O O O O O O O O O X
X O O O O O O O O O O O O O O O O O O O X O O O O O O O O O O X O O O O O O X O O O O O X O O O O O O X X M O M O M M X M M O M X
X O O O O O O O O X X X X X O O O O O O O O O O O O O O O O O O X X X O O O X O O O O O O O O O O O X X X O U O U O O X O O U O X
X O O O O O O O O X O O O O O O O O O O O O O O O O O O O O O O O O O O O O X X X O O O O O O X X X X X X X X X X X X X X X X X X
X O O O O O O O O O O O O O O O X X O O X X X X X X O O O O O O O O O O X X X O O O O O O U O O O O O O O O O O O O O O O O O O X
X O O U O O X O O O O O O O O O O O M O X O O O O O O O O O O O U O O O O O O O O O O O X X X O O O O O O O O O O O O O O O O O X
X O O X X O X O O O O O O X O O U O O O X O O O O O O O O O X X X X O O O O O O O O O O X O O X O O O O O O O O M O O O O O X X X
X O O O O O O O O O O O O X X X X X X X X O O O O O O O O O X X X O O O O O O O O O O O O O O O X O O O O O O O O O O O O X X X X
X O O O O O O O O O O O O O O O O O O O X O O O O O O O O X X O O O O O O O X O O O O O O O O O O X X X X X X X X X X X X X X X X
X O O O O O O O O O O O O O O O O O O O X O O O O O X X X O O O O O O O O X X X X X X X O O O O O O O O O O O O O O O X O O O O X
X O O O O O O X O O O X X O O O O O O O X O O O O O O O X O O O O O O O X X X X X X X X X O O O O O X X X X X X X O O O O O O O X
X O O P O O X X O O X X X O O O O O O O O O O O O O O O X O O O O O O X X X X X O O O O O O O O X X O O O O O O O O O O O O O O X
X O O O X X X X X X X X X O O O O O O O O O O O O O O O O O O O O O X X X X X X O O O O O O O O M O O O O O O O O O O O O O O O X
X X X X X X X X X X X X X X O O O O O O O O X O O O O O O O O O X X X X X X X X O O X X X X X O O O O O O O U O O O X X X W O X X
X O O O O O O O O O O O O O O O O O O O X O O O O O O O O O O X O O O O O O O O O O X X X X X X X X X X X O X X O X X X X X X X X
X O O O O O O O O O O O O O O O O O O O O O M M M M M M X O O M O O O O O O O O O O O O X O O O O O O O O O O O O X X X X X X X X
X O O O O O O O O O O O O O O O O O O O O O O O O O O O O O O O O U U U U U U O O O O O X O O O O O O O O O O O O O O O O O O O X
X X X X X X X X X X X X X X X X X X X X X X X X X X X X X X X X X X X X X X X X X X X X X X X X X X X X X X X X X X X X X X X X X