Z O O O O O O O O O O O O O O O O O O O O O O O O O O O O O O O O O O O O O O O O O O O O O O O O O Z Z
Z O O O O O O O O O O O O O O O O O O O O O O O O O O O O O O O O O O O O O O O O O O O O O O O O O Z Z
Z O O O O O O O O O O O O O O O O O O O O O O O O O O O O O O O O O O O O O O O O O O O O O O O O O Z Z
Z O O O O O O O O O O O O O O O O O O O O O O O O O O O O O O O O O O O O O O O O O O O O O O O O M Z Z
Z O O O O O O O O O O O O O O O O O O O O O O O O O O O O O O O X B B B X O O O O O O O O O O O O O Z Z
Z O O O O O O O O O O O O O O O O O O O O O X X X X X X X X X X X X X X X X X X X X X X X X O O O O Z Z
Z O O O O O O O O O O O O O O O O O O O O O L X Z Z Z Z Z Z Z Z Z Z Z Z Z Z Z Z Z Z Z Z Z X O O O O Z Z
Z O O O O O O O O O O O O O O O O O O O O O L X Z Z Z X X X X X X X X X X X X X X X X X X X O O O O Z Z
Z O O O O O O O O O O O O O O O O O O O X X X X Z Z Z X T T T T T T T T T T X O O O O O O O O O O O Z Z
Z O O O O O O O O O O O O O O O O O X X X Z Z Z Z Z Z X O O O O O O O O O O O O O O O O O O O O O O Z Z
Z O O O O O O O O O O O O O O O O O L X Z Z Z Z Z Z Z X O O O O O O O O O O O O O O O O O O O O O O Z Z
Z O O O O O O O O O O O O O O O O O X X X X X X X X X X O O O O O O O O O O O O O O O O O O O O O O Z Z
Z O O O O O O O O O O O O X X O O O O O O O O O O X Z R O O O O O O O O O O O O O X B B X O O O O O Z Z
Z O O O O O O O O O O O O X R O O O O O O O O O O X Z R O O O O O O O O O O O J O X X X X X X X X X Z Z
Z O O O O O O O O O O O O X X O O O O O O O O O O X Z R O O O O O O X X O U O X X X Z Z Z Z Z Z Z Z Z Z
Z O O O O O O O O O O O O O O O O O X X O O O O O X Z R O O O O O O X X O O O X Z Z Z Z Z Z Z Z Z Z Z Z
Z O O O O O O O O O O O O O O O O O O O O O O O O X Z R O O O X X X X X X X X X X X X X X X X X X X Z Z
Z O O O O O O O O O O O O O O O O O O O O O O O O X Z R O O O O O O O O O X T X O O O O O O O X T X Z Z
Z O O O O O O O O O O O O O O O O O O O O O O X X X Z R O O O O O O O O O O O O O O O O O O O O W O Z Z
Z O O O O O O O O O O O O O O O O J O O O O O X Z X Z R O O O O X B X O O O O O O O X B X O O O O O Z Z
Z O O O O O O O O O O O X X O O X X O O X X X X Z Z Z X X X X X X X X X X X X X X X X X X X X X X X Z Z
Z O O O O O O O X X X X X X X X X X O O X Z Z Z Z Z Z Z Z Z Z Z Z Z Z Z Z Z Z Z Z Z Z Z Z Z Z Z Z Z Z Z
Z O O O O O O O L X Z Z Z Z Z Z Z X O O X Z Z Z Z Z Z Z Z Z Z Z Z Z Z Z Z Z Z Z Z Z Z Z Z Z Z Z Z Z Z Z
Z O O O O O O O L X Z Z Z Z Z Z Z X O O X Z Z Z Z Z Z Z Z Z Z Z Z Z Z Z Z Z Z Z Z Z Z Z Z Z Z Z Z Z Z Z
Z O O O O O X X X X Z Z Z Z Z Z Z X O O X Z Z Z Z Z Z Z Z Z Z Z Z Z Z Z Z Z Z Z Z Z Z Z Z Z Z Z Z Z Z Z
Z O O O O O L X Z Z Z Z Z Z Z Z Z X O O X Z Z Z Z Z Z Z Z Z Z Z Z Z Z Z Z Z Z Z Z Z Z Z Z Z Z Z Z Z Z Z
Z O P O X X X X Z Z Z Z Z Z Z Z Z X O O X Z Z Z Z Z Z Z Z Z Z Z Z Z Z Z Z Z Z Z Z Z Z Z Z Z Z Z Z Z Z Z
Z O O O X Z Z Z Z X Z Z Z Z Z Z Z X O O X Z Z Z Z Z Z Z Z Z Z Z Z Z Z Z Z Z Z Z Z Z Z Z Z Z Z Z Z Z Z Z
X X X X X X X X X X X X X X X X X X O O X X X X X X X X X X X X X X X X X X X X X X X X X X X X X X X X