Z O O O O O O O O O O O O O O O O O O O O O O O O O O O O O O O O O O O O O O O O O O O O O O O O O Z Z
Z O O O O O O O O O O O O O O O O O O O O O O O O O O O O O O O O O O O O O O O O O O O O O O O O O Z Z
Z O O O O O O O O O O O O O O O O O O O O O O O O O O O O O O O O O O O O O O O O O O O O O O O O O Z Z
Z O O O O O O O O O O O O O O O O O O O O O O O O O O O O P O O O O O O O O O O O O O O O O O O O O Z Z
Z O O O O O O O O O O O O O O O O O O O O O O O O O O O O O O O O O J O O O O O O O O O O O O O O O Z Z
Z O X X X X X O O O O O O O O O O O O O X X X X O O O O O O O O O O O O O O O O O O O O O O O O O O Z Z
Z O L Z Z Z R O O O O O O O O O O O O O X X X X O O O O O O O O O O O O O O O O O O O O O O O J O J Z Z
Z O X X X X X O X X O O O O X X O O O O O O O O O O O O O X X X X X X X X O O O O O O O O O O O O O Z Z
Z O O O O O O O X X O U U O X X O O O O O O O O O O X X X X X X X X X X X O O O O O O O O O O O O O Z Z
Z O O O O O O O X R O O O O L X O O O O O O O O O O X X X X O O O O O O X O O X X O O X X O O O O O Z Z
Z O O O Z O O O X R B B B B L X O O O O O O O O O O O O O O O O O O O O X O O X X B B X X O O O O O Z Z
Z O O O Z O O O X X X X X X X X O O O O O O O O O O O O O O O O O O O O X X X X X X X X X O O O O O Z Z
Z O O O Z O O O O O O O O O O X O O O O O O O O O O O O O O O O O O O O O O O O S O S O S O O O O O Z Z
Z X X O Z O O O O O O O O O O X O O O O O O O O O O O O O O O O O O O O O O O O O O O O O O O O O O Z Z
Z X X O Z O O O O O O O O O O X O O O O O O O O O O O O O O O O O O O O O O O O X X X X X X X X X X Z Z
Z O O O O O O O O O O O O X X X O O O O O O O O O O O O O O O O O O O U O O O O X X X X X X X X X X Z Z
Z O O O O O O O O O O O O L X X O O O O O O O O O O O O O O O O O O O O O O O O O O O O O O O O O O Z Z
Z O O O O O O O O O O X X X X X O O O O O O O O O O O O O O O O O O O O O O O O O O O O O O O O O O Z Z
Z O O O O O O O O O O L X X X X O O O O O O O O O O O O O O O O O O O X X X X X X X X O O O O O O O Z Z
Z X X X X O O O O X X X X X X X O O O O O O O O O O O O O O O O O O O X X X X X X X X O O O O O O O Z Z
Z X X X X O O O O X X X X X X X O O O O O O O O O O O O O O O O O X X X X T T T T X X X X O O O O O Z Z
Z O O O O O O O O O O O O O O O O O O O O O O O O O O O O O O O O X X X T O O O O T X X X O O O O O Z Z
Z O O O O O O O O O O O O O O O O O O O O O O O O O O O O O O O O X T T O O O O O O O O O O O O O O Z Z
Z O O O O O O O O O O O O O O O O O O O O O X X O O O O O O O O O O O O O O O O O O O O O O O O O O Z Z
Z O O O O O O O O O O O O O O O O O O O O O X X O O O O O O O O O O O O O O O O O O O O O O O O O O Z Z
Z O O O O O O O O O O O O O O O O O O O O O O O O O O X X O O O O O O W O O O O O O O O O O O O O O Z Z
Z O O O O O O O O O O O O O O O O O O O O O O O O O O X X O O O O O O O O O O O O O O O O O O O O O Z Z
Z O O O O O O O O O O O O O O O O O O O O O O O O O O O O O O O O X X X X X O O O X O O O X X X X X Z Z
Z O O O O O O O O O O O O O O O O O O O O O O O O O O O O O O O O X X X X X O O O O O O O X X X X X X X