O O O O O O O O O O O O O O O O O O O O O O O O O O O O O O O O O O O O O O O O
X O O O O O O O O O O O O O O O O O O O O O O O O O O O O O O O O O O O O O O X
X O O O O O O O O O O O O O O O O O O O O O O O O O O O O O O O O O O O O O O X
X O O O O O O O O O O O O O O O O O O O O O O O O O O O O O O O O O O O O O O X
X O O O O O O O O O O O O O O X X X X X X O O O O O O O O O O O O O O O O O O X
X O O O O O O O O O O O O O X O O O O O X O O O O O O O O O O O O O O O O O O X
X O O O O O O O P O O O O O O O O O O O X O O O O O O O O O O O O O O O O O O X
X O O O O O O O O O O U O O O O O O O O X O O O O O O O O O O O O O O O O O O X
X O O O O O O O X X X X X O O O O O O O X O O O O O O O O O O O O O O O O O O X
X O O O O O O O O O O O O O O O W O O O X O O O O O O O O O O O O O O O O O O X
X O O O O O O O O O O O O O O O O O O O X O O O O O O O O O O O O O O O O O O X
X O O O O O O O O O O O O X X X X X O O X O O O O O O O O O O O O O O O O O O X
X O O O O O O O O O O O O O O O O O O O X O O O O O O O O O O O O X X O O O O X
X O O O O O O O O O O O O O O O O O O O X O O O O O O O O O O X X O O O O O O X
X O O O O O O O X X X X X O O O O O O O X O O O O O O O O X X O O O O O O O X X
X O O O O O O O O O O O O O O O O O O O X O O O O X X X X O O O O O O O O X X X
X O O O X O O O O O O O O O O O O O O O X O O O O O O O X O O O O O O O X X X X
X O O O O X O O O O O O O O O O O O O O O O O O O O O O X O O O O O O X X X X X
X O O O O O X O O O O O O O O O O O O O O O O O O O O O X O O O O O X X X X X X
X O O O O O O O O O O O O O O O O O O O O O O O O O O O X O O O O X X X X X X X
X O O O M O O O O O O O O O O O O O O O O O M O M O M O X W O O X X X X X X X X
X O O O O O O O O O O O O O O O O O O O O O O O O O O O X O O X X X X X X X X X
X X X X X X X X X X X X X X X X X X X X X X X X X X X X X X X X X X X X X X X X